"filename", "language", "Java", "comment", "blank", "total"
"d:\CourseCode\Pattern\FarmRPG\FarmRPG\src\Battle\BattleMemberBase.java", "Java", -1, 0, 0, -1
"d:\CourseCode\Pattern\FarmRPG\FarmRPG\src\Choice\Plant.java", "Java", 1, 0, 0, 1
"d:\CourseCode\Pattern\FarmRPG\FarmRPG\src\Choice\UseInventoryItemOnce.java", "Java", -1, 0, 0, -1
"d:\CourseCode\Pattern\FarmRPG\FarmRPG\src\Choice\battle\BattleBackpack.java", "Java", -2, 0, -1, -3
"d:\CourseCode\Pattern\FarmRPG\FarmRPG\src\Item\Inventory.java", "Java", -4, 2, 0, -2
"d:\CourseCode\Pattern\FarmRPG\FarmRPG\src\Item\Weapon\NullWeapon.java", "Java", -1, 0, -1, -2
"d:\CourseCode\Pattern\FarmRPG\FarmRPG\src\TXT\Expression.java", "Java", 6, 0, 1, 7
"d:\CourseCode\Pattern\FarmRPG\FarmRPG\src\TXT\Interpreter.java", "Java", 35, 0, 7, 42
"d:\CourseCode\Pattern\FarmRPG\FarmRPG\src\TXT\MinusExpression.java", "Java", 17, 0, 6, 23
"d:\CourseCode\Pattern\FarmRPG\FarmRPG\src\TXT\MultiplyExpression.java", "Java", 17, 0, 7, 24
"d:\CourseCode\Pattern\FarmRPG\FarmRPG\src\TXT\NumberExpression.java", "Java", 18, 0, 7, 25
"d:\CourseCode\Pattern\FarmRPG\FarmRPG\src\TXT\PlusExpression.java", "Java", 17, 0, 5, 22
"Total", "-", 102, 2, 31, 135