"filename", "language", "Java", "comment", "blank", "total"
"d:\CourseCode\Pattern\FarmRPG\FarmRPG\src\Item\Buff\AttackBuff.java", "Java", 30, 0, 8, 38
"d:\CourseCode\Pattern\FarmRPG\FarmRPG\src\Item\Buff\Buff.java", "Java", 16, 0, 5, 21
"d:\CourseCode\Pattern\FarmRPG\FarmRPG\src\Item\Buff\DefenceBuff.java", "Java", 34, 0, 5, 39
"d:\CourseCode\Pattern\FarmRPG\FarmRPG\src\Item\Buff\EnergyBuff.java", "Java", 17, 0, 5, 22
"d:\CourseCode\Pattern\FarmRPG\FarmRPG\src\Item\Buff\HealthBuff.java", "Java", 22, 0, 6, 28
"d:\CourseCode\Pattern\FarmRPG\FarmRPG\src\Item\Buff\IBuff.java", "Java", 5, 0, 1, 6
"d:\CourseCode\Pattern\FarmRPG\FarmRPG\src\Item\Dice.java", "Java", 36, 0, 7, 43
"d:\CourseCode\Pattern\FarmRPG\FarmRPG\src\Item\Inventory.java", "Java", 320, 2, 53, 375
"d:\CourseCode\Pattern\FarmRPG\FarmRPG\src\Item\InventoryItem.java", "Java", 75, 1, 19, 95
"d:\CourseCode\Pattern\FarmRPG\FarmRPG\src\Item\InventoryIterator.java", "Java", 37, 0, 6, 43
"d:\CourseCode\Pattern\FarmRPG\FarmRPG\src\Item\InventoryMgr.java", "Java", 53, 2, 13, 68
"d:\CourseCode\Pattern\FarmRPG\FarmRPG\src\Item\ItemExtention.java", "Java", 3, 0, 3, 6
"d:\CourseCode\Pattern\FarmRPG\FarmRPG\src\Item\ItemTypes.java", "Java", 4, 0, 1, 5
"d:\CourseCode\Pattern\FarmRPG\FarmRPG\src\Item\Iterator.java", "Java", 5, 0, 2, 7
"d:\CourseCode\Pattern\FarmRPG\FarmRPG\src\Item\Pool\ObjectPool.java", "Java", 28, 0, 7, 35
"d:\CourseCode\Pattern\FarmRPG\FarmRPG\src\Item\Potion\DefencePotion.java", "Java", 12, 0, 6, 18
"d:\CourseCode\Pattern\FarmRPG\FarmRPG\src\Item\Potion\EnergyPotion.java", "Java", 12, 0, 4, 16
"d:\CourseCode\Pattern\FarmRPG\FarmRPG\src\Item\Potion\HealingPotion.java", "Java", 12, 0, 3, 15
"d:\CourseCode\Pattern\FarmRPG\FarmRPG\src\Item\Potion\IPotion.java", "Java", 5, 0, 2, 7
"d:\CourseCode\Pattern\FarmRPG\FarmRPG\src\Item\Potion\PotionAdapter.java", "Java", 21, 0, 7, 28
"d:\CourseCode\Pattern\FarmRPG\FarmRPG\src\Item\Potion\PotionBase.java", "Java", 10, 0, 2, 12
"d:\CourseCode\Pattern\FarmRPG\FarmRPG\src\Item\Potion\PotionFactory.java", "Java", 72, 0, 10, 82
"d:\CourseCode\Pattern\FarmRPG\FarmRPG\src\Item\Potion\PotionType.java", "Java", 5, 1, 2, 8
"d:\CourseCode\Pattern\FarmRPG\FarmRPG\src\Item\Potion\StrengthPotion.java", "Java", 12, 0, 3, 15
"d:\CourseCode\Pattern\FarmRPG\FarmRPG\src\Item\Weapon\Bullet.java", "Java", 25, 0, 3, 28
"d:\CourseCode\Pattern\FarmRPG\FarmRPG\src\Item\Weapon\BulletPool.java", "Java", 14, 1, 5, 20
"d:\CourseCode\Pattern\FarmRPG\FarmRPG\src\Item\Weapon\Gun.java", "Java", 18, 0, 4, 22
"d:\CourseCode\Pattern\FarmRPG\FarmRPG\src\Item\Weapon\Iweapon.java", "Java", 4, 0, 1, 5
"d:\CourseCode\Pattern\FarmRPG\FarmRPG\src\Item\Weapon\NullWeapon.java", "Java", 7, 0, 2, 9
"d:\CourseCode\Pattern\FarmRPG\FarmRPG\src\Item\Weapon\Sword.java", "Java", 37, 0, 7, 44
"d:\CourseCode\Pattern\FarmRPG\FarmRPG\src\Item\Weapon\WeaponAdapter.java", "Java", 16, 0, 5, 21
"d:\CourseCode\Pattern\FarmRPG\FarmRPG\src\Item\Weapon\WeaponAttackData.java", "Java", 18, 0, 4, 22
"d:\CourseCode\Pattern\FarmRPG\FarmRPG\src\Item\Weapon\WeaponBase.java", "Java", 17, 0, 4, 21
"d:\CourseCode\Pattern\FarmRPG\FarmRPG\src\Item\Weapon\WeaponFactory.java", "Java", 37, 0, 7, 44
"d:\CourseCode\Pattern\FarmRPG\FarmRPG\src\Item\Weapon\WeaponType.java", "Java", 4, 0, 2, 6
"Total", "-", 1043, 7, 224, 1274